
AIzaSyCqSU24Z2TgtLliBsrhJoJCJ0fSO22VBeQ

key_mixtral: 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


1. TÆ° váº¥n lá»™ trÃ¬nh â€“ tour â€“ chi phÃ­ theo nhu cáº§u
Ná»™i dung	MÃ´ táº£ triá»ƒn khai
ğŸ—ºï¸ Gá»£i Ã½ lá»‹ch trÃ¬nh du lá»‹ch	Dá»±a trÃªn ngÃ y Ä‘i, ngÃ¢n sÃ¡ch, sá»Ÿ thÃ­ch (vÃ­ dá»¥: thiÃªn nhiÃªn, tÃ¢m linh, biá»ƒn...)
ğŸ§® TÃ­nh toÃ¡n chi phÃ­ Æ°á»›c lÆ°á»£ng	Gá»“m vÃ© tham quan, Äƒn uá»‘ng, Ä‘i láº¡i, lÆ°u trÃº
ğŸ“ Gá»£i Ã½ lá»‹ch trÃ¬nh theo vÃ¹ng	Háº¡ Long 1 ngÃ y, CÃ´ TÃ´ 3 ngÃ y, UÃ´ng BÃ­ â€“ YÃªn Tá»­ 2 ngÃ y...
ğŸ§  Sá»­ dá»¥ng AI Ä‘á»ƒ pháº£n há»“i tá»± nhiÃªn	LLM xá»­ lÃ½ Ä‘áº§u vÃ o ngÆ°á»i dÃ¹ng â†’ táº¡o káº¿ hoáº¡ch cá»¥ thá»ƒ

ğŸ”¹ 2. Gá»£i Ã½ mÃ³n Äƒn â€“ Ä‘á»‹a Ä‘iá»ƒm â€“ lá»… há»™i
Ná»™i dung	MÃ´ táº£
ğŸ² Gá»£i Ã½ mÃ³n Äƒn Ä‘áº·c sáº£n	Theo Ä‘á»‹a phÆ°Æ¡ng, theo thá»i gian trong ngÃ y (Äƒn sÃ¡ng, trÆ°a...)
ğŸï¸ Äá»‹a Ä‘iá»ƒm tham quan	Theo loáº¡i hÃ¬nh: thiÃªn nhiÃªn, tÃ¢m linh, giáº£i trÃ­, miá»…n phÃ­
ğŸ‰ Lá»… há»™i Ä‘ang diá»…n ra	Theo thá»i Ä‘iá»ƒm (trong thÃ¡ng), theo vá»‹ trÃ­ du lá»‹ch
ğŸ—ºï¸ Báº£n Ä‘á»“ du lá»‹ch	CÃ³ thá»ƒ hiá»ƒn thá»‹ báº£n Ä‘á»“ Google hoáº·c sÆ¡ Ä‘á»“ du lá»‹ch cá»§a tá»‰nh

ğŸ”¹ 3. Äáº·t dá»‹ch vá»¥ qua API
Dá»‹ch vá»¥	CÃ¡ch káº¿t ná»‘i
ğŸ¨ Äáº·t phÃ²ng khÃ¡ch sáº¡n	TÃ­ch há»£p API booking (Mytour, Traveloka, API tá»‰nh náº¿u cÃ³)
ğŸ« Äáº·t vÃ© tham quan	API vÃ© Ä‘iá»‡n tá»­ náº¿u cÃ³ (nhÆ° vÃ© vá»‹nh Háº¡ Long, YÃªn Tá»­...)
ğŸš— Äáº·t xe â€“ taxi	Gá»£i Ã½ liÃªn káº¿t vá»›i Grab, taxi ná»™i tá»‰nh
ğŸ½ï¸ Äáº·t bÃ n Äƒn táº¡i nhÃ  hÃ ng	TÃ¹y nhÃ  hÃ ng liÃªn káº¿t â€“ há»— trá»£ gá»­i yÃªu cáº§u Ä‘áº·t bÃ n

ğŸ”¹ 4. ThÃ´ng tin du lá»‹ch thiáº¿t yáº¿u
Ná»™i dung	MÃ´ táº£
ğŸ›Ÿ Trung tÃ¢m há»— trá»£ du khÃ¡ch	ThÃ´ng tin sá»‘ Ä‘iá»‡n thoáº¡i, báº£n Ä‘á»“, Ä‘á»‹a chá»‰
â›‘ï¸ Tráº¡m y táº¿, cáº¥p cá»©u	Gá»£i Ã½ vá»‹ trÃ­ gáº§n nháº¥t
ğŸ“¢ Tin tá»©c kháº©n cáº¥p	Cáº£nh bÃ¡o thá»i tiáº¿t, lá»… há»™i Ä‘Ã´ng ngÆ°á»i, Ä‘Æ°á»ng táº¯c, giÃ¡ vÃ© tÄƒng...
ğŸ“ƒ Há»i Ä‘Ã¡p thÆ°á»ng gáº·p	Giá» má»Ÿ cá»­a, thá»§ tá»¥c lÃªn tÃ u, giÃ¡ vÃ© tham quan, thuÃª xe mÃ¡y,...





1. TÃ¬m viá»‡c theo nhu cáº§u
TÃ­nh nÄƒng	MÃ´ táº£ triá»ƒn khai
ğŸ§  Gá»£i Ã½ cÃ´ng viá»‡c phÃ¹ há»£p	Dá»±a trÃªn thÃ´ng tin ngÆ°á»i dÃ¹ng: ngÃ nh nghá», kinh nghiá»‡m, trÃ¬nh Ä‘á»™ há»c váº¥n, khu vá»±c mong muá»‘n
ğŸ“ Gá»£i Ã½ viá»‡c lÃ m gáº§n vá»‹ trÃ­	Náº¿u ngÆ°á»i dÃ¹ng chia sáº» vá»‹ trÃ­ (GPS hoáº·c khu vá»±c tá»‰nh thÃ nh)
ğŸ”„ Gá»£i Ã½ cáº­p nháº­t theo thá»i gian thá»±c	TÃ­ch há»£p API hoáº·c database cáº­p nháº­t tá»« Trung tÃ¢m dá»‹ch vá»¥ viá»‡c lÃ m, doanh nghiá»‡p

ğŸ”¹ 2. Tráº£ lá»i cÃ¢u há»i thÆ°á»ng gáº·p
CÃ¢u há»i	Gá»£i Ã½ cÃ¡ch xá»­ lÃ½
"LÆ°Æ¡ng tá»‘i thiá»ƒu hiá»‡n táº¡i lÃ  bao nhiÃªu?"	Sá»­ dá»¥ng knowledge base + LLM Ä‘á»ƒ tráº£ lá»i cáº­p nháº­t
"Doanh nghiá»‡p cÃ³ há»— trá»£ nhÃ  á»Ÿ khÃ´ng?"	Láº¥y tá»« thÃ´ng tin chi tiáº¿t tá»«ng job
"Thá»i gian thá»­ viá»‡c bao lÃ¢u?"	Theo tá»«ng ngÃ nh nghá», luáº­t lao Ä‘á»™ng

â†’ CÃ³ thá»ƒ triá»ƒn khai há»‡ thá»‘ng FAQ + Semantic Search hoáº·c RAG Ä‘á»ƒ chatbot tÃ¬m vÃ  tráº£ lá»i chÃ­nh xÃ¡c.

ğŸ”¹ 3. Ná»™p CV â€“ ÄÄƒng kÃ½ phá»ng váº¥n
TÃ­nh nÄƒng	MÃ´ táº£
ğŸ“„ Cho phÃ©p ngÆ°á»i dÃ¹ng gá»­i CV	Upload file PDF/Word qua chatbot
ğŸ“¨ Gá»­i thÃ´ng tin vá» nhÃ  tuyá»ƒn dá»¥ng	Gá»­i kÃ¨m thÃ´ng tin ngÆ°á»i dÃ¹ng + file qua email hoáº·c API webhook cá»§a doanh nghiá»‡p
ğŸ“… Äáº·t lá»‹ch phá»ng váº¥n tá»± Ä‘á»™ng	Chatbot há»i thá»i gian phÃ¹ há»£p â†’ lÆ°u vÃ o MongoDB â†’ doanh nghiá»‡p xÃ¡c nháº­n sau

ğŸ”¹ 4. Gá»£i Ã½ há»c nghá» / Ä‘Ã o táº¡o láº¡i
TÃ­nh nÄƒng	MÃ´ táº£
ğŸ“š Gá»£i Ã½ trung tÃ¢m Ä‘Ã o táº¡o	Gá»£i Ã½ nÆ¡i há»c nghá» phÃ¹ há»£p: sÆ¡ cáº¥p, ngáº¯n háº¡n
ğŸ“ˆ Lá»™ trÃ¬nh phÃ¡t triá»ƒn nghá»	Dá»±a vÃ o má»¥c tiÃªu: nÃ¢ng báº­c, chuyá»ƒn ngÃ nh, há»c online...




1. Táº¡o chatbot riÃªng cho doanh nghiá»‡p
TÃ­nh nÄƒng	MÃ´ táº£
ğŸ¨ TÃ¹y chá»‰nh giao diá»‡n vÃ  ná»™i dung	TÃªn cÃ´ng ty, logo, giá»›i thiá»‡u, cÃ¢u chÃ o
ğŸ¤– Giao diá»‡n táº¡o luá»“ng há»i â€“ Ä‘Ã¡p (khÃ´ng cáº§n code)	Giao diá»‡n kÃ©o tháº£ cÃ¢u há»i â†’ cÃ¢u tráº£ lá»i â†’ hÃ nh Ä‘á»™ng
ğŸ”— Táº¡o mÃ£ nhÃºng	NhÃºng chatbot vÃ o website, Facebook, Zalo OA

ğŸ”¹ 2. Quáº£n lÃ½ há»“ sÆ¡ ngÆ°á»i dÃ¹ng â€“ khÃ¡ch hÃ ng
TÃ­nh nÄƒng	MÃ´ táº£
ğŸ—‚ï¸ Danh sÃ¡ch khÃ¡ch hÃ ng tÆ°Æ¡ng tÃ¡c	LÆ°u lá»‹ch sá»­ ngÆ°á»i chat, nhu cáº§u, tráº¡ng thÃ¡i xá»­ lÃ½
ğŸ“„ Nháº­n thÃ´ng tin ná»™p CV / Ä‘áº·t lá»‹ch	Tá»± Ä‘á»™ng phÃ¢n loáº¡i há»“ sÆ¡ theo tráº¡ng thÃ¡i
ğŸ“¤ Táº£i xuá»‘ng file CSV	Xuáº¥t thÃ´ng tin khÃ¡ch hÃ ng / á»©ng viÃªn gá»­i qua mail

ğŸ”¹ 3. PhÃ¢n tÃ­ch hÃ nh vi ngÆ°á»i dÃ¹ng
Chá»©c nÄƒng	MÃ´ táº£
ğŸ“Š Thá»‘ng kÃª lÆ°á»£t tÆ°Æ¡ng tÃ¡c theo ngÃ y	Biá»ƒu Ä‘á»“ line hoáº·c pie chart
ğŸ” Tá»« khÃ³a Ä‘Æ°á»£c há»i nhiá»u nháº¥t	Lá»c top 10 cÃ¢u Ä‘Æ°á»£c há»i
ğŸ“ˆ Äo lÆ°á»ng hiá»‡u quáº£: tá»· lá»‡ pháº£n há»“i, tá»· lá»‡ ná»™p CV	DÃ¹ng Ä‘á»ƒ tá»‘i Æ°u há»™i thoáº¡i hoáº·c nhÃ¢n sá»± phá»¥ trÃ¡ch

ğŸ”¹ 4. Tá»± Ä‘á»™ng há»c & gá»£i Ã½ pháº£n há»“i tá»‘t hÆ¡n
Há»‡ thá»‘ng	MÃ´ táº£
ğŸ¤– Há»c tá»« dá»¯ liá»‡u ngÆ°á»i dÃ¹ng	PhÃ¢n tÃ­ch cÃ¢u há»i chÆ°a cÃ³ pháº£n há»“i Ä‘Ãºng â†’ gá»£i Ã½ admin cáº­p nháº­t
ğŸ“˜ ThÃªm vÃ o bá»™ kiáº¿n thá»©c ná»™i bá»™	Admin nháº­p FAQ, hÆ°á»›ng dáº«n xá»­ lÃ½, chÃ­nh sÃ¡ch... Ä‘á»ƒ chatbot há»c thÃªm

